  Welcome
 #########
##.......##
#.........#
#.........#
#.........#
##.......##
 #########
