  Welcome
 ╔═══════╗                       ╔═══════╗
╔╝.......╚╗                     ╔╝.......╚╗
║.........╚═════════════════════╝.........║
║.........................................║
║.........╔═════════════════════╗.........║
╚╗.......╔╝                     ╚╗.......╔╝
 ╚═══════╝                       ╚═══════╝
