  Welcome
 #########                       #########
##.......##                     ##.......##
#.........#######################.........#
#.........................................#
#.........#######################.........#
##.......##                     ##.......##
 #########                       #########
