  
 #########        Welcome        #########
##.......##                     ##.......##
#.........#######################.........#
#.........................................#
#.........#######################.........#
##.......##                     ##.......##
 ####.####                       ####.####
    #.#                             #.#
    #.#                             #.#
    #.#                             #.#
    #.#                             #.#
    #.#                             #.#
    #.#                             #.#
    #.#                             #.#
 ####.####                       ####.####
##.......##                     ##.......##
#.........#######################.........#
#.........................................#
#.........#######################.........#
##.......##                     ##.......##
 #########                       #########
